R 800 600

NO ./path_to_the_north_texture
SO ./path_to_the_south_texture
WE ./path_to_the_west_texture
EA ./path_to_the_east_texture
S ./path_to_the_sprite_texture

F 220,100,0
C 225,30,0

111111111
100000001
100000001
100000001
10 000001
101000001
100000001
1000N0001
100000011
100000001
100001001
100000001
100000001
100000001
100000001
111111111
