R 1000 1000

NO ./path_to_the_north_texture
SO ./path_to_the_south_texture
WE ./path_to_the_west_texture
EA ./path_to_the_east_texture
S ./path_to_the_sprite_texture

F 220,100,0
C 225,30,0

111111111
100000001
101110101
101111101
1100N1001
101011001
101010101
100000001
111111111
