R 800 600

NO ./textures/icestone.xpm
SO ./textures/hearthstone.xpm
WE ./textures/iron.xpm
EA ./textures/wood.xpm
S ./sprites1024/lichking1024.xpm

F 220,100,0
C 225,30,0

111111111
100022221
100122221
122022021
102102021
102020021
102000021
102000021
122000221
1220N0201
122000221
102002201
102022201
100202001
112222001
100001001
100000001
111111111
