R 888888800 8888888600

NO ./textures/icestone.xpm
SO ./textures/hearthstone.xpm
WE ./textures/iron.xpm
EA ./textures/wood.xpm
S ./sprites1024/lichking1024.xpm

F 220,100,0
C 225,30,0

111111111
100000001
100100001
100000001
101100001
101020001
101000001
101000001
100000001
1000N0001
100000011
100001001
100001001
100001001
111001001
100001001
100000001
111111111
