R 800 800

NO ./textures/icestone.xpm
SO ./textures/hearthstone.xpm
WE ./textures/iron.xpm
EA ./textures/wood.xpm
S ./sprites1024/sylvanas1024.xpm

F 220,100,0
C 225,30,0

        11 1111111111111111111111
        1111000000110000000000001
        1011222201110000222000201
        102222220000000020200000111111111111111111111111111
11111111101122000111000022200000111111111111111111111111111
10000000001100000111011111111111110111     1111111111111111
11110111111111011100000010001111111111111111111111111111111
11110111111111011101011110000000000000000000000000000000001
1100000011010101110001 110011111111111111111111111111111111
10002000S00000001100011110001
10000000000000001101010000001      
11000011110100111111011110001
1100001 1111101 1011110100011
1111111 11 1111 11111111111111111      1111111
