R 99999999999 9999999999999999

NO ./textures/icestone.xpm
SO ./textures/hearthstone.xpm
WE ./textures/iron.xpm
EA ./textures/wood.xpm

S2 ./sprites/portal.xpm
S3 ./sprites/sylvanas1024.xpm
S4 ./sprites/illidan1024.xpm
S5 ./sprites/kil-jaeden.xpm
S6 ./sprites/lichking1024.xpm
S7 ./sprites/babydragon.xpm
S8 ./sprites/murloc.xpm
S9 ./sprites/dragon/dragon1.xpm

C  ./textures/space2.xpm
F  ./textures/hearth.xpm

11111111111111111111111111111111111111111111111111111111111111111111111111111111
11100000001111111000000000001111111000001111110000000000001110011111111001110011
11100111100011111001111111111111110011100111111111100111111110011111111001110011
11100111111000111001111111111111001111110011111111100111111110011111111001110011
11100111111110111001111111111110011111111001111111100111111110011111111001110011
11100111111110111001111111111110011111111001111111100111111110011111111001110011
11100111111110111000000001111110000020000001111111100111111110000000000001110011
11100111111110111001111111111110011111111001111111100111111110011111111001110011
11100111111000111001111111111110011111111001111111100111111110011111111001110011
11100111100011111001111111111110011111111001111111100111111110011111111001111111
11100000001111111000000000011110011111111001111111100111111110011111111001110011
11111111111111111111111111111111111111111111111111111111111111111111111111111111
                         111111111111111111111111111111
                     11111000000000000000000000000000911111
                   111000000030100000000070000300000700000111
                111100008080001810800006000700800160000080001111
              1110000000000006001000001000080700007087003000040111
            11100000113000808000010007111000040007701007000000000111
          111000077001111114100011000000010003000010400778000780004111
        1110001100000000030000500100008051000000810000000000077750001111
      11100000070705700000000080000000800100800100050801011000000070000111
    111000005001077008807608800000060000016000100000060000100008080000000111
   11006003000018000001006000037800011000108070170770000777010007880000000011
  1100008008480000000000800061000000166661007000000077080105001004000750000011
  1000600050000030000050000000000600066661000000607710000106000010000000300001
 110040000600800000000000040077700000666611508000700170300000000001000000000011
 100000000011111111100000000008005000001000077080000100000004011111111100000001
1100000000111      11111000000000000080100007706030110000011111      11100700011
18000700411            111100860000080010080000100010001111            110500001
1008000011                111000080000011100000340000111                11070001
160500001                   11100001700106118000000111                   1000001
100010001                     1110070010000000000111                     1007001
1008104011                      111000140007000111                      11000001
100010080111                      10000000080001                      1110700001
100014080001111111                10061111000001                1111111000000001
110018000000000001111111        111000000080000111        1111111000000001000011
 100000080000000000000011111111110070010070000000111111111100000000077701005001
 100610058110060008400000000000000000010080000007001000000003000000000010000011
  1101800000801110080000008001000006000000010000000100077000000007008010000011
   11030500300800000830080480600070000000011000000018008000111111800010000011
    100000000800000050007000100004001118000011100001007770030400010000000001
    110007700040011100007001060770011 1111001 110001000060000077000810000011
     1000777000000010000001110770011  1000001  1100111118110080000800050001
     100080000077010170778000000011   1000001   110100000080815080000000001
    110000000600800077077070700001   110011111   101007000088000011111111111
   1106008011110000070700100400001   105000001   1000000000100040010087000011
  11008800006000008100000806100001  11000N00011  10000008010000000407000000011
 1100000000437000810007000800000411 10011100031 1100708001050008007000000770011
  1100001111800300000000100100000011101000000011100000800000600000050500700011
   11000000050701110800701000000000010000000000000070003007071811111000770011
    111110000000000100101111100800103000880500008087001110000300000111111111
        1110060070711000000000001000000006000008070788000070000000000111         
          110000011100001114000070000030081050000000000300706010000011           
           1110000000816007000508000001100060600811100068077700000111
             111000000700000000001111000080000003000000000770000111
               11100110005300010100000000000000000000070007000111
                 1100000000000003004000700000111000000000070111
                  11003000011110000111111170770771111000033311
                   100000001  107003001  107670071  100003331
                   111117041  100000041  100000701  100003331
                   105000001  111110001  177007771  100060001
                   100000001  100000001  100111771  100050001
                   100700031  100307001  100770071  100000001
                   100111111  100000001  100077771  100004001
                   100000001  100011111  170074071  101111111
                   100700001  100073001  100711111  100000001
                   106000001  160000001  100070771  100000601
                   100400001  100000001  100007601  105000001
                   100111001  111100001  170700701  111110001
                   100007001  103000001  105770771  100000001
                   100000001  176000001  101111071  100006001
                   103700001  100050001  107070771  100000001
                   100000041  100011111  107070061  100000001
                   111110001  100700001  170707771  100111111
                   100700001  100070001  106707001  100000001
                   107000301  164000001  111117071  100000001
                   100011111  111100031  170770771  106000001
                   100700001  100000001  100011111  111110001
                   100000001  100000001  100000001  100000001
                   163000701  103004001  100000001  100000001
                   111111111  111111111  111111111  111111111
