R 1000 800

NO ./textures/icestone.xpm
SO ./textures/hearthstone.xpm
WE ./textures/iron.xpm
EA ./textures/wood.xpm
S2 ./sprites/sylvanas1024.xpm
S3 ./sprites/murloc.xpm
S4 ./sprites/illidan1024.xpm
S5 ./sprites/kil-jaeden.xpm
S6 ./sprites/lichking1024.xpm
S7 ./sprites/onyxian.xpm
S8 ./sprites/red-dragon.xpm
S9 ./sprites/dragon/dragon1.xpm

F 80,80,80
C 0,0,0
                         111111111111111111111111111111
                     11111000000000000000000000000000011111
                   111000000000000000000000000000000000000111
                111100000000000000000000000000000000000000001111
              1110000000000000000000000000000000000000000000000111
            11100000000000000000000000000000000000000000000000000111
          111000000000000000000000000000000000000000000000000000000111
        1110000000000000000000000000000000000000000000000000000000000111
      11100000000000000011111111111111111111111111111111100000000000000111
    111000000000000000001222133314441555166617771888199910000000000000000111
   11000000000000000000012221333144415551666177718881999100000000000000000011
  1100000000000000000000122213331444155516661777188819991000000000000000000011
  1000000000000000000000000000000000000000000000000000000000000000000000000001
 11000000000000000000000000000000000000000000000000000N000000000000000000000011
 100000000011111111100000000000000000000000000000000000000000011111111100000001
1100000000111      11111000000000000000000000000000000000011111      11100000011
10000000011            111100000000000000000000000000001111            110000001
1000000011                111000000000000000000000000111                11000001
100000001                   11100000000000000000000111                   1000001
100000001                     1110000000000000000111                     1000001
1000000011                      111000000000000111                      11000001
100000000111                      10000000000001                      1110000001
100000000001111111                10000000000001                1111111000000001
110000000000000001111111        111000000000000111        1111111000000000000011
 100000000000000000000011111111110000000000000000111111111100000000000000000001
 100000000000000000000000000000000000000000000000000000000000000000000000000011
  1100000000000000000000000000000000000000000000000000000000000000000000000011
   11000000000000000000000000000000000000000000000000000000000000000000000011
    100000000000000000000000000000001110000011100000000000000000000000000001
    110000000000000000000000000000011 1000001 110000000000000000000000000011
     1000000000000000000000000000011  1000001  1100000000000000000000000001
     100000000000000000000000000011   1000001   110000000000000000000000001
    110000000000000000000000000001   110000011   100000000000000000000000011
   1100000000000000000000000000001   100000001   1000000000000000000000000011
  11000000000000000000000000000001  11000000011  10000000000000000000000000011
 1100000000000000000000000000000011 10000000001 1100000000000000000000000000011
  1100000000000000000000000000000011100000000011100000000000000000000000000011
   11000000000000000000000000000000000000000000000000000000000000000000000011
    111110000000000000000000000000000000000000000000000000000000000000111111
        1110000000000000000000000000000000000000000000000000000000000111         
          110000000000000000000000000000000000000000000000000000000011           
           1110000000000000000000000000000000000000000000000000000111
             111000000000000000000000000000000000000000000000000111
               11100000000000000000000000000000000000000000000111
                 1100000000000000000000000000000000000000000111
                  11000000011110000000111100000001111000000011
                   100000001  100000001  100000001  100000001
                   100000001  100000001  100000001  100000001
                   100000001  100000001  100000001  100000001
                   100000001  100000001  100000001  100000001
                   100000001  100000001  100000001  100000001
                   100000001  100000001  100000001  100000001
                   100000001  100000001  100000001  100000001
                   100000001  100000001  100000001  100000001
                   100000001  100000001  100000001  100000001
                   100000001  100000001  100000001  100000001
                   100000001  100000001  100000001  100000001
                   100000001  100000001  100000001  100000001
                   100000001  100000001  100000001  100000001
                   100000001  100000001  100000001  100000001
                   100000001  100000001  100000001  100000001
                   100000001  100000001  100000001  100000001
                   100000001  100000001  100000001  100000001
                   100000001  100000001  100000001  100000001
                   100000001  100000001  100000001  100000001
                   100000001  100000001  100000001  100000001
                   100000001  100000001  100000001  100000001
                   100000001  100000001  100000001  100000001
                   111111111  111111111  111111111  111111111
