R 800 600

NO ./textures/icestone.xpm
SO ./textures/hearthstone.xpm
WE ./textures/iron.xpm
EA ./textures/wood.xpm
S2 ./sprites/sylvanas1024.xpm
S3 ./sprites/murloc.xpm
S4 ./sprites/illidan1024.xpm
S5 ./sprites/kil-jaeden.xpm
S6 ./sprites/lichking1024.xpm
S7 ./sprites/onyxian.xpm
S8 ./sprites/red-dragon.xpm
S0 ./sprites/dragon/dragon1.xpm

F 80,80,80
C 0,0,0
                         111111111111111111111111111111
                     11111000000000000000000000000000011111
                   111000000020000000000000000000000000000111
                111100003000000300300000000000300100000000001111
              1110000000000000000000001000030000000030000000000111
            11100000110000003000040003111000000000000000000000000111
          111000000000000060000010000000000002000000400003000000000111
        1110000000000000020000000000003050000000300000000000000000001111
      11100000000005000000000030000000300000300000000300000000000000000111
    111000005000000003000000300000000000000000000000000000500000030000000111
   11000000000006000001006000020300011000003010100300000000000000330000000011
  1100000003000000000000300001000000100000000000000000030000000000000000000011
  1000000000000000000000000000000000000003000000600000000006000000000000200001
 110040000600000000000000040030000000000001003000000070000000000000000000000011
 100000000011111111100000000003005000000000000000000000000000011111111100000001
1100000000111      11111000000000000030000000000000000000011111      11100000011
10000700011            111100000000080000030000100000001111            110000001
1000000011                111000030000001100000000000111                11000001
100000001                   11100001000109110000000111                   1000001
100000001                     1110000010000000000111                     1000001
1003000011                      111000100000000111                      11000001
100000000111                      10000000000001                      1110000001
100004000001111111                10000000000001                1111111000000001
110000000000000001111111        111000000000000111        1111111000000000000011
 100000030000000000000011111111110000010000000000111111111100000000000000000001
 1000000000000000000000000000000000000100N0000000000000000000000000000000000011
  1100000000000000000000000001000000000000010000000000000000000001003000000011
   11000500200000000300000000000070000000011000000000003000000000100000000011
    100000000300000000000000100000001110000011100000000000020000010000000001
    110000000040011100006001000000011 1000001 110000000060000000000000000011
     1000000000000010000001000000011  1000001  1100003000000030000000000001
     100030000000000000003000000011   1000001   110000000000010000000000001
    110000000600300003000000000001   110000011   100000000001000010000000011
   1100003000000000000000100000001   100000001   1000000000100040010030000011
  11000000006000000100000000000001  11000000011  10000003010000000000000000011
 1100000000007000300000000000000011 10000000001 1100000001000003000000000000011
  1100000000300200000000100000000011100000000011100000300000000000050000000011
   11000000050001000300700000000000000000000000000000000000000010000000000011
    111110000000000000000000000300000000300000000000001110000200000000111111
        1110000010000000000000000000000000000000070000000000000000000111         
          110000011100001110000070000000011000000000000000000010000011           
           1110000000310000000003000001100000600311100003000000000111
             111000000000000000001111000030000000000000000000000111
               11100110000200010100000000000000000000000000000111
                 1100000000000000004000000000111000000000000111
                  11000000011110000000111100000001111000000011
                   100000001  100000001  100000001  100000001
                   100000001  100000001  100000001  100000001
                   100000001  100000001  100000001  100000001
                   100000001  100000001  100000001  100000001
                   100000001  100000001  100000001  100000001
                   100000001  100000001  100000001  100000001
                   100000001  100000001  100000001  100000001
                   100000001  100000001  100000001  100000001
                   100000001  100000001  100000001  100000001
                   100000001  100000001  100000001  100000001
                   100000001  100000001  100000001  100000001
                   100000001  100000001  100000001  100000001
                   100000001  100000001  100000001  100000001
                   100000001  100000001  100000001  100000001
                   100000001  100000001  100000001  100000001
                   100000001  100000001  100000001  100000001
                   100000001  100000001  100000001  100000001
                   100000001  100000001  100000001  100000001
                   100000001  100000001  100000001  100000001
                   100000001  100000001  100000001  100000001
                   100000001  100000001  100000001  100000001
                   100000001  100000001  100000001  100000001
                   111111111  111111111  111111111  111111111
