R 1200 800

NO ./textures/icestone.xpm
SO ./textures/hearthstone.xpm
WE ./textures/iron.xpm
EA ./textures/wood.xpm
S2 ./sprites/sylvanas1024.xpm
S3 ./sprites/red-dragon.xpm
S4 ./sprites/illidan1024.xpm
S5 ./sprites/kil-jaeden.xpm
S6 ./sprites/lichking1024.xpm
S7 ./sprites/babydragon.xpm
S8 ./sprites/murloc.xpm
S9 ./sprites/dragon/dragon1.xpm

F 80,80,80
C 0,0,0
                         111111111111111111111111111111
                     11111000000000000000000000000000011111
                   111000000020000000000000000000000000000111
                111100008000000800800000000000800100000000001111
              1110000000000000000000001000080000000080000000000111
            11100000110000008000040008111000000000000000000000000111
          111000000000000060000010000000000002000000400008000000000111
        1110000000000000020000000000008050000000800000000000000000001111
      11100000000005000000000080000000800000800000000800000000000000000111
    111000005000000008000000800000000000000000000000000000500000080000000111
   11000000000006000001006000020800011000008010100800000000000000880000000011
  1100000008000000000000800001000000100000000000000000080000000000000000000011
  1000000000000000000000000000000000000008000000600000000006000000000000200001
 110040000600000000000000040080000000000001008000000070000000000000000000000011
 100000000011111111100000000008005000000000000000000000000000011111111100000001
1100000000111      11111000000000000080000000000000000000011111      11100000011
10000700011            111100000000080000080000100000001111            110000001
1000000011                111000080000001100000000000111                11000001
100000001                   11100001000109110000000111                   1000001
100000001                     1110000010000000000111                     1000001
1008000011                      111000100000000111                      11000001
100000000111                      10000000000001                      1110000001
100004000001111111                10000000000001                1111111000000001
110000000000000001111111        111000000000000111        1111111000000000000011
 100000080000000000000011111111110000010000000000111111111100000000000000000001
 1000000000000000000000000000000000000100N0000000000000000000000000000000000011
  1100000000000000000000000001000000000000010000000000000000000001008000000011
   11000500200000000800000000000070000000011000000000008000000000100000000011
    100000000800000000000000100000001110000011100000000000020000010000000001
    110000000040011100006001000000011 1000001 110000000060000000000000000011
     1000000000000010000001000000011  1000001  1100008000000080000000000001
     100080000000000000008000000011   1000001   110000000000010000000000001
    110000000600800008000000000001   110000011   100000000001000010000000011
   1100008000000000000000100000001   100000001   1000000000100040010080000011
  11000000006000000100000000000001  11000000011  10000008010000000000000000011
 1100000000007000800000000000000011 10000000001 1100000001000008000000000000011
  1100000000800200000000100000000011100000000011100000800000000000050000000011
   11000000050001000800700000000000000000000000000000000000000010000000000011
    111110000000000000000000000800000000800000000000001110000200000000111111
        1110000010000000000000000000000000000000070000000000000000000111         
          110000011100001110000070000000011000000000000000000010000011           
           1110000000810000000008000001100000600811100008000000000111
             111000000000000000001111000080000000000000000000000111
               11100110000200010100000000000000000000000000000111
                 1100000000000000004000000000111000000000000111
                  11000000011110000000111100000001111000000011
                   100000001  100000001  100000001  100000001
                   100000001  100000001  100000001  100000001
                   100000001  100000001  100000001  100000001
                   100000001  100000001  100000001  100000001
                   100000001  100000001  100000001  100000001
                   100000001  100000001  100000001  100000001
                   100000001  100000001  100000001  100000001
                   100000001  100000001  100000001  100000001
                   100000001  100000001  100000001  100000001
                   100000001  100000001  100000001  100000001
                   100000001  100000001  100000001  100000001
                   100000001  100000001  100000001  100000001
                   100000001  100000001  100000001  100000001
                   100000001  100000001  100000001  100000001
                   100000001  100000001  100000001  100000001
                   100000001  100000001  100000001  100000001
                   100000001  100000001  100000001  100000001
                   100000001  100000001  100000001  100000001
                   100000001  100000001  100000001  100000001
                   100000001  100000001  100000001  100000001
                   100000001  100000001  100000001  100000001
                   100000001  100000001  100000001  100000001
                   111111111  111111111  111111111  111111111
