R 1000 800

NO ./textures/icestone.xpm
SO ./textures/hearthstone.xpm
WE ./textures/iron.xpm
EA ./textures/wood.xpm

S2 ./sprites/portal.xpm
S3 ./sprites/sylvanas1024.xpm
S4 ./sprites/illidan1024.xpm
S5 ./sprites/kil-jaeden.xpm
S6 ./sprites/lichking1024.xpm
S7 ./sprites/babydragon.xpm
S8 ./sprites/murloc.xpm
S9 ./sprites/dragon/dragon1.xpm

C  ./textures/space.xpm
F  ./textures/hearth.xpm

111111111111111111111111111111111111111111111111111111111111111111111111111111111111111111111111111
111111111111111111111111111111111111111111111111111111111111111111111111111111111111111111111111111
111111111111111111111111111111111111111111111111111111111111111111111111111111111111111111111111111
111111111111111111111111111111111111111111111111111111111111111111111111111111111111111111111111111
111111111111111111111111111111111111111111111111111111111111111111111111111111111111111111111111111
111111111111111111111111111111111111111111111111111111111111111111111111111111111111111111111111111
111111111111111111111111111111111111111111111111111111111111111111111111111111111111111111111111111
111111111111111111111111111111111111111111111111111111111111111111111111111111111111111111111111111
111111111111111111111111111111111111111111111111111111111111111111111111111111111111111111111111111
111111111111111111111111111111111111111111111111111111111111111111111111111111111111111111111111111
                  111                                                                              
                  10111                     1111111111                                             
                  11001111                  100000000111111                                        
                   1110N01111               111111110000001111111                                  
                     111000011111                  111111000000011111                              
                       1110000001111111                 1110000000001111                           
                         11110000000001111111111         110000000000001111                        
                            1111100000000000000111111111110000000000000000111                      
                                11111100000000000000000000000000000000000000111                    
                              111111111000000000000000000000000000000000000000111                  
            111111111111111111100000000000000000000000000000000001111110000000001                  
       11111100000000000000000000000000000000000000000000000000000000111100000011                  
       10000001111100000000000000000000000000000000000000000000000000000000000011111               
       11111111   1100000000000000000000000000000000000000000000000000000000000000011111111        
               11100000000000000000000000000000000000000000000000000000000000000000000000011111    
         11111110000000000000000000000000000000000000000000111000000000000000000000000000110001111 
     1111100000000000000000000000000000000000000110000000000001111000011100000000000000000111000011
   111000000000000000000000000000000000000001111111000000011000011110011111100001100000100000000001
 11100000000000000000000000000000000000001111     110000000111100001111    111011 11001111000000001
 10011111110000000000000000000000000000111         110000000111111000011111  111   1101  1110110001
 1111    1100000000000000000000000000011            110000000000111110000011111     111    10111011
        1100000000000000000000000000001              11100000000011111111000001111111      111 111 
      111100000000000000000000000000001                1110000000001    11111000000011111111111    
   11110000000000000000000000000000000111                1110000001111111   11111100000000000001   
  11000000000000000000000000000000000000111                11110000000001        11111110000111    
 110000000100000000000000000000000000000001111                11111111111              111111      
11001111111000000000000000000000000000000000011111                                                 
10111     110000000000000000000000000000000000000111111                                            
111        11000000000000000000000000000000000000000001111111                                      
         11100000000000000000000000000000000000000000000000011111                                  
        1100000000000000000000000000000000000000000000000000000011111                              
       1100001111000000000000000000000000000000000000000000000000000111                            
       1000111  111000000000000000000000000000000000000000000000000000111                          
       10111      110000000000000000000000000000000000000000000000000000111                        
       111         110000000000000000000000000000000000000000000000000000011                       
                    110000000000000000000000000000000000000000000000000000011                      
                     11000000000000000000000000000000000000000000000000000011                      
                      1000000000000000000000000000000000000000000000000000001                      
                      1111111111111111111111111111111111111111111111111111111                      
111111111111111111111111111111111111111111111111111111111111111111111111111111111111111111111111111
111111111111111111111111111111111111111111111111111111111111111111111111111111111111111111111111111
111111111111111111111111111111111111111111111111111111111111111111111111111111111111111111111111111
111111111111111111111111111111111111111111111111111111111111111111111111111111111111111111111111111
111111111111111111111111111111111111111111111111111111111111111111111111111111111111111111111111111
111111111111111111111111111111111111111111111111111111111111111111111111111111111111111111111111111
111111111111111111111111111111111111111111111111111111111111111111111111111111111111111111111111111
111111111111111111111111111111111111111111111111111111111111111111111111111111111111111111111111111
111111111111111111111111111111111111111111111111111111111111111111111111111111111111111111111111111
111111111111111111111111111111111111111111111111111111111111111111111111111111111111111111111111111
