R 999999999999 999999999999999

NO ./textures/bark.xpm
SO ./textures/rock.xpm
WE ./textures/brick.xpm
EA ./textures/stonebrick.xpm

S2 ./sprites/portal.xpm
S3 ./sprites/sylvanas1024.xpm
S4 ./sprites/illidan1024.xpm
S5 ./sprites/kil-jaeden.xpm
S6 ./sprites/lichking1024.xpm
S7 ./sprites/babydragon.xpm
S8 ./sprites/murloc.xpm
S9 ./sprites/dragon/dragon1.xpm

C  ./textures/orion.xpm
F  ./textures/sand.xpm

111111111111111111111111111111111111111111111111111111111111111111111111111111111111111111111111111
111111111111111111111111111111111111111111111111111111111111111111111111111111111111111111111111111
111111111111111111111111111111111111111111111111111111111111111111111111111111111111111111111111111
111111111111111111111111111111111111111111111111111111111111111111111111111111111111111111111111111
111111111111111111111111111111111111111111111111111111111111111111111111111111111111111111111111111
111111111111111111111111111111111111111111111111111111111111111111111111111111111111111111111111111
111111111111111111111111111111111111111111111111111111111111111111111111111111111111111111111111111
111111111111111111111111111111111111111111111111111111111111111111111111111111111111111111111111111
111111111111111111111111111111111111111111111111111111111111111111111111111111111111111111111111111
111111111111111111111111111111111111111111111111111111111111111111111111111111111111111111111111111
                  111                                                                              
                  10111                     1111111111                                             
                  11001111                  100088000111111                                        
                   1110801111               111111110000801111111                                  
                     111000011111                  111111000070011111                              
                       1110080001111111                 1110000800001111                           
                         11110000880001111111111         110000000700001111                        
                            1111100000007000000111111111110008070800080000111                      
                                11111100000700070000000008007000080708000000111                    
                              111111111000080000070007080070007000008707008000111                  
            111111111111111111100000700007000000008700000080070001111110008080001                  
       11111100807080008000000800000000008007000000007870000000000000111100000011                  
       10000001111100700880088008870007000800708000070000780080708070808007000011111               
       11111111   1100000080800700007008080008008007008800077000080080000080700000011111111        
               11108000007080000007888007000007088700000000000800700000070080078007700000011111    
         11111110700000707080080700000000008000077088080000111000000887000070080008800077110001111 
     1111100080008807000007080780008078070000000110070080000001111000011100007000000078000111080011
   111070000000000008000008007080007007000001111111000000011000011110011111100001108000100800070001
 11100000887000800700070008800007000000001111     110007000111100001111    111011 11001111008008001
 10011111110000087000080800080700007000111         110088700711111000011111  111   1101  1110110701
 1111    1100008800080088007088077000011            110000000070111110000011111     111    10111011
        1100087000800008008707800080001              11100800080011111111000001111111      111 111 
      111100000078000788000000000000001                1110780070001    11111000000011111111111    
   11110770807008000000870000080780070111                1110700001111111   11111100000000000001   
  11000008000080000700800078008000700000111                11110000000001        11111110000111    
 110087000100800070080080000000080000870001111                11111111111              111111      
11001111111070000708087000800700008700070000011111                                                 
10111     110007000800087080080007007000800000000111111                                            
111        11008870880080080000000000700000070800000001111111                                      
         11100000080008000700007800000070008070080000000000811111                                  
        1108070800070800808000800080000007000007807008800870000011111                              
       1107001111000000080007000007008880070080087087000700008000000111                            
       1000111  111000708800000808007000008000000007000008000000800707111                          
       10111      110008700088070000700080700078080077800007007800000070111                        
       111         110000078000080080708800007000700808080000700780008000011                       
                    110008007800008007007000700008078000708000088008080070011                      
                     11000080070000000000800008000007080807800000000800000011                      
                      1008008000700088000007000080000780000078000000N00087001                      
                      1111111111111111111111111111111111111111111111111111111                      
111111111111111111111111111111111111111111111111111111111111111111111111111111111111111111111111111
111111111111111111111111111111111111111111111111111111111111111111111111111111111111111111111111111
111111111111111111111111111111111111111111111111111111111111111111111111111111111111111111111111111
111111111111111111111111111111111111111111111111111111111111111111111111111111111111111111111111111
111111111111111111111111111111111111111111111111111111111111111111111111111111111111111111111111111
111111111111111111111111111111111111111111111111111111111111111111111111111111111111111111111111111
111111111111111111111111111111111111111111111111111111111111111111111111111111111111111111111111111
111111111111111111111111111111111111111111111111111111111111111111111111111111111111111111111111111
111111111111111111111111111111111111111111111111111111111111111111111111111111111111111111111111111
111111111111111111111111111111111111111111111111111111111111111111111111111111111111111111111111111
